################
##            ##
#             G#
#              #
#              #
#              #
#     ####     #
#     ####     #
#     ####     #
#     ####     #
#              #
#              #
#              #
#P             #
##            ##
################