################
#G             #
# #####  ##### #
# #####  ##### #
# #####  ##### #
#              #
# ############ #
# #    ##    # #
#   ##    ##   #
# ############ #
#              #
# #####  ##### #
# #####  ##### #
# #####  ##### #
#  o o   o    P#
################
