################
#              #
# #####  ##### #
# #####  ##### #
# #####  ##### #
#      GG      #
# ############ #
# #    ##    # #
#   ##    ##   #
# ############ #
#              #
# #####  ##### #
# #####  ##### #
# #####  ##### #
#  ooo se ooo P#
################